"filename", "language", "TypeScript", "HTTP", "comment", "blank", "total"
"c:\Serious Project\chc\chc-backend\identity-service\src\common\EnvVars.ts", "TypeScript", 25, 0, 5, 2, 32
"c:\Serious Project\chc\chc-backend\identity-service\src\common\HttpStatusCodes.ts", "TypeScript", 64, 0, 259, 64, 387
"c:\Serious Project\chc\chc-backend\identity-service\src\configs\passport.config.ts", "TypeScript", 35, 0, 0, 5, 40
"c:\Serious Project\chc\chc-backend\identity-service\src\controllers\auth.controller.ts", "TypeScript", 21, 0, 0, 6, 27
"c:\Serious Project\chc\chc-backend\identity-service\src\controllers\user.controller.ts", "TypeScript", 76, 0, 0, 12, 88
"c:\Serious Project\chc\chc-backend\identity-service\src\error\AlreadyExistError.ts", "TypeScript", 12, 0, 3, 5, 20
"c:\Serious Project\chc\chc-backend\identity-service\src\error\ApiError.ts", "TypeScript", 8, 0, 3, 3, 14
"c:\Serious Project\chc\chc-backend\identity-service\src\error\ApiErrorCodes.ts", "TypeScript", 70, 0, 5, 19, 94
"c:\Serious Project\chc\chc-backend\identity-service\src\error\IsNotNumberError.ts", "TypeScript", 12, 0, 3, 3, 18
"c:\Serious Project\chc\chc-backend\identity-service\src\error\LengthError.ts", "TypeScript", 32, 0, 3, 4, 39
"c:\Serious Project\chc\chc-backend\identity-service\src\error\NotEmptyError.ts", "TypeScript", 12, 0, 15, 7, 34
"c:\Serious Project\chc\chc-backend\identity-service\src\error\NotFoundError.ts", "TypeScript", 12, 0, 3, 4, 19
"c:\Serious Project\chc\chc-backend\identity-service\src\error\NotInEnumError.ts", "TypeScript", 13, 0, 0, 4, 17
"c:\Serious Project\chc\chc-backend\identity-service\src\error\NotNullError.ts", "TypeScript", 12, 0, 3, 4, 19
"c:\Serious Project\chc\chc-backend\identity-service\src\error\RouteError.ts", "TypeScript", 9, 0, 4, 5, 18
"c:\Serious Project\chc\chc-backend\identity-service\src\helpers\camelCaseifyWithDateConversion.ts", "TypeScript", 39, 0, 12, 7, 58
"c:\Serious Project\chc\chc-backend\identity-service\src\helpers\removeNullValue.ts", "TypeScript", 16, 0, 9, 6, 31
"c:\Serious Project\chc\chc-backend\identity-service\src\helpers\sanitation.ts", "TypeScript", 0, 0, 1, 1, 2
"c:\Serious Project\chc\chc-backend\identity-service\src\helpers\Validator.ts", "TypeScript", 59, 0, 43, 18, 120
"c:\Serious Project\chc\chc-backend\identity-service\src\index.ts", "TypeScript", 6, 0, 2, 3, 11
"c:\Serious Project\chc\chc-backend\identity-service\src\middlewares\auth.middleware.ts", "TypeScript", 48, 0, 1, 9, 58
"c:\Serious Project\chc\chc-backend\identity-service\src\middlewares\user.middleware.ts", "TypeScript", 56, 0, 1, 5, 62
"c:\Serious Project\chc\chc-backend\identity-service\src\middlewares\util.middleware.ts", "TypeScript", 10, 0, 0, 2, 12
"c:\Serious Project\chc\chc-backend\identity-service\src\models\Comment.ts", "TypeScript", 29, 0, 0, 5, 34
"c:\Serious Project\chc\chc-backend\identity-service\src\models\Group.ts", "TypeScript", 51, 0, 0, 5, 56
"c:\Serious Project\chc\chc-backend\identity-service\src\models\Notification.ts", "TypeScript", 44, 0, 0, 5, 49
"c:\Serious Project\chc\chc-backend\identity-service\src\models\Post.ts", "TypeScript", 50, 0, 0, 5, 55
"c:\Serious Project\chc\chc-backend\identity-service\src\models\Reaction.ts", "TypeScript", 34, 0, 0, 5, 39
"c:\Serious Project\chc\chc-backend\identity-service\src\models\friendRequest.schema.ts", "TypeScript", 36, 0, 4, 6, 46
"c:\Serious Project\chc\chc-backend\identity-service\src\models\user.schema.ts", "TypeScript", 65, 0, 6, 8, 79
"c:\Serious Project\chc\chc-backend\identity-service\src\pre-start.ts", "TypeScript", 0, 0, 8, 3, 11
"c:\Serious Project\chc\chc-backend\identity-service\src\repositories\friendRequest.repository.ts", "TypeScript", 25, 0, 0, 6, 31
"c:\Serious Project\chc\chc-backend\identity-service\src\repositories\user.repository.ts", "TypeScript", 71, 0, 8, 18, 97
"c:\Serious Project\chc\chc-backend\identity-service\src\routes\auth.routes.ts", "TypeScript", 28, 0, 0, 7, 35
"c:\Serious Project\chc\chc-backend\identity-service\src\routes\index.routes.ts", "TypeScript", 7, 0, 0, 5, 12
"c:\Serious Project\chc\chc-backend\identity-service\src\routes\types\express\index.d.ts", "TypeScript", 6, 0, 1, 5, 12
"c:\Serious Project\chc\chc-backend\identity-service\src\routes\types\express\misc.ts", "TypeScript", 7, 0, 1, 5, 13
"c:\Serious Project\chc\chc-backend\identity-service\src\routes\types\types.ts", "TypeScript", 9, 0, 1, 5, 15
"c:\Serious Project\chc\chc-backend\identity-service\src\routes\users.routes.ts", "TypeScript", 42, 0, 1, 9, 52
"c:\Serious Project\chc\chc-backend\identity-service\src\server.ts", "TypeScript", 50, 0, 12, 21, 83
"c:\Serious Project\chc\chc-backend\identity-service\src\services\auth.service.ts", "TypeScript", 55, 0, 0, 10, 65
"c:\Serious Project\chc\chc-backend\identity-service\src\services\database.service.ts", "TypeScript", 29, 0, 1, 6, 36
"c:\Serious Project\chc\chc-backend\identity-service\src\services\friendRequest.service.ts", "TypeScript", 72, 0, 6, 13, 91
"c:\Serious Project\chc\chc-backend\identity-service\src\services\user.service.ts", "TypeScript", 81, 0, 0, 12, 93
"c:\Serious Project\chc\chc-backend\identity-service\src\tests\ApiTest.http", "HTTP", 0, 6, 1, 1, 8
"c:\Serious Project\chc\chc-backend\identity-service\src\types\api.types.ts", "TypeScript", 11, 0, 0, 4, 15
"c:\Serious Project\chc\chc-backend\identity-service\src\types\auth.types.ts", "TypeScript", 11, 0, 0, 2, 13
"c:\Serious Project\chc\chc-backend\identity-service\src\types\user.types.ts", "TypeScript", 24, 0, 0, 6, 30
"c:\Serious Project\chc\chc-backend\identity-service\src\util\handlers.ts", "TypeScript", 10, 0, 0, 2, 12
"c:\Serious Project\chc\chc-backend\identity-service\src\util\misc.ts", "TypeScript", 10, 0, 9, 4, 23
"c:\Serious Project\chc\chc-backend\identity-service\src\Validators\util.Validator.ts", "TypeScript", 0, 0, 0, 1, 1
"Total", "-", 1504, 6, 434, 382, 2326