"filename", "language", "TypeScript", "HTTP", "comment", "blank", "total"
"c:\Serious Project\chc\chc-backend\identity-service\group-backend-project\src\configs\database.config.ts", "TypeScript", 29, 0, 0, 6, 35
"c:\Serious Project\chc\chc-backend\identity-service\group-backend-project\src\configs\passport.config.ts", "TypeScript", 35, 0, 0, 5, 40
"c:\Serious Project\chc\chc-backend\identity-service\group-backend-project\src\constant\EnvVars.ts", "TypeScript", 25, 0, 5, 2, 32
"c:\Serious Project\chc\chc-backend\identity-service\group-backend-project\src\constant\HttpStatusCodes.ts", "TypeScript", 64, 0, 259, 64, 387
"c:\Serious Project\chc\chc-backend\identity-service\group-backend-project\src\constant\dir.ts", "TypeScript", 2, 0, 0, 2, 4
"c:\Serious Project\chc\chc-backend\identity-service\group-backend-project\src\controllers\auth.controller.ts", "TypeScript", 21, 0, 0, 6, 27
"c:\Serious Project\chc\chc-backend\identity-service\group-backend-project\src\controllers\group.controller.ts", "TypeScript", 77, 0, 0, 9, 86
"c:\Serious Project\chc\chc-backend\identity-service\group-backend-project\src\controllers\post.controller.ts", "TypeScript", 0, 0, 0, 1, 1
"c:\Serious Project\chc\chc-backend\identity-service\group-backend-project\src\controllers\user.controller.ts", "TypeScript", 138, 0, 0, 24, 162
"c:\Serious Project\chc\chc-backend\identity-service\group-backend-project\src\error\AlreadyExistError.ts", "TypeScript", 12, 0, 3, 5, 20
"c:\Serious Project\chc\chc-backend\identity-service\group-backend-project\src\error\ApiError.ts", "TypeScript", 8, 0, 3, 3, 14
"c:\Serious Project\chc\chc-backend\identity-service\group-backend-project\src\error\ApiErrorCodes.ts", "TypeScript", 103, 0, 5, 27, 135
"c:\Serious Project\chc\chc-backend\identity-service\group-backend-project\src\error\IsNotNumberError.ts", "TypeScript", 12, 0, 3, 3, 18
"c:\Serious Project\chc\chc-backend\identity-service\group-backend-project\src\error\LengthError.ts", "TypeScript", 32, 0, 3, 4, 39
"c:\Serious Project\chc\chc-backend\identity-service\group-backend-project\src\error\NotEmptyError.ts", "TypeScript", 12, 0, 15, 7, 34
"c:\Serious Project\chc\chc-backend\identity-service\group-backend-project\src\error\NotFoundError.ts", "TypeScript", 12, 0, 3, 4, 19
"c:\Serious Project\chc\chc-backend\identity-service\group-backend-project\src\error\NotInEnumError.ts", "TypeScript", 13, 0, 0, 4, 17
"c:\Serious Project\chc\chc-backend\identity-service\group-backend-project\src\error\NotNullError.ts", "TypeScript", 12, 0, 3, 4, 19
"c:\Serious Project\chc\chc-backend\identity-service\group-backend-project\src\error\RouteError.ts", "TypeScript", 9, 0, 4, 5, 18
"c:\Serious Project\chc\chc-backend\identity-service\group-backend-project\src\helpers\camelCaseifyWithDateConversion.ts", "TypeScript", 53, 0, 17, 12, 82
"c:\Serious Project\chc\chc-backend\identity-service\group-backend-project\src\helpers\handlers.ts", "TypeScript", 10, 0, 0, 2, 12
"c:\Serious Project\chc\chc-backend\identity-service\group-backend-project\src\helpers\removeNullValue.ts", "TypeScript", 16, 0, 9, 6, 31
"c:\Serious Project\chc\chc-backend\identity-service\group-backend-project\src\helpers\sanitation.ts", "TypeScript", 0, 0, 1, 1, 2
"c:\Serious Project\chc\chc-backend\identity-service\group-backend-project\src\helpers\validation.ts", "TypeScript", 68, 0, 43, 18, 129
"c:\Serious Project\chc\chc-backend\identity-service\group-backend-project\src\index.ts", "TypeScript", 6, 0, 2, 3, 11
"c:\Serious Project\chc\chc-backend\identity-service\group-backend-project\src\middlewares\auth.middleware.ts", "TypeScript", 48, 0, 1, 9, 58
"c:\Serious Project\chc\chc-backend\identity-service\group-backend-project\src\middlewares\group.middleware.ts", "TypeScript", 52, 0, 0, 4, 56
"c:\Serious Project\chc\chc-backend\identity-service\group-backend-project\src\middlewares\post.middleware.ts", "TypeScript", 0, 0, 0, 1, 1
"c:\Serious Project\chc\chc-backend\identity-service\group-backend-project\src\middlewares\user.middleware.ts", "TypeScript", 67, 0, 1, 6, 74
"c:\Serious Project\chc\chc-backend\identity-service\group-backend-project\src\middlewares\util.middleware.ts", "TypeScript", 10, 0, 0, 2, 12
"c:\Serious Project\chc\chc-backend\identity-service\group-backend-project\src\pre-start.ts", "TypeScript", 0, 0, 8, 3, 11
"c:\Serious Project\chc\chc-backend\identity-service\group-backend-project\src\repositories\friendRequest.repository.ts", "TypeScript", 63, 0, 0, 7, 70
"c:\Serious Project\chc\chc-backend\identity-service\group-backend-project\src\repositories\group.repository.ts", "TypeScript", 47, 0, 0, 8, 55
"c:\Serious Project\chc\chc-backend\identity-service\group-backend-project\src\repositories\groupJoinRequest.repository.ts", "TypeScript", 79, 0, 0, 5, 84
"c:\Serious Project\chc\chc-backend\identity-service\group-backend-project\src\repositories\user.repository.ts", "TypeScript", 101, 0, 8, 19, 128
"c:\Serious Project\chc\chc-backend\identity-service\group-backend-project\src\routes\auth.routes.ts", "TypeScript", 28, 0, 0, 7, 35
"c:\Serious Project\chc\chc-backend\identity-service\group-backend-project\src\routes\group.routes.ts", "TypeScript", 52, 0, 0, 10, 62
"c:\Serious Project\chc\chc-backend\identity-service\group-backend-project\src\routes\index.routes.ts", "TypeScript", 11, 0, 0, 4, 15
"c:\Serious Project\chc\chc-backend\identity-service\group-backend-project\src\routes\post.routes.ts", "TypeScript", 3, 0, 0, 3, 6
"c:\Serious Project\chc\chc-backend\identity-service\group-backend-project\src\routes\types\express\index.d.ts", "TypeScript", 6, 0, 1, 5, 12
"c:\Serious Project\chc\chc-backend\identity-service\group-backend-project\src\routes\types\express\misc.ts", "TypeScript", 7, 0, 1, 5, 13
"c:\Serious Project\chc\chc-backend\identity-service\group-backend-project\src\routes\types\types.ts", "TypeScript", 9, 0, 1, 5, 15
"c:\Serious Project\chc\chc-backend\identity-service\group-backend-project\src\routes\user.routes.ts", "TypeScript", 79, 0, 1, 16, 96
"c:\Serious Project\chc\chc-backend\identity-service\group-backend-project\src\schema\friendRequest.schema.ts", "TypeScript", 36, 0, 4, 6, 46
"c:\Serious Project\chc\chc-backend\identity-service\group-backend-project\src\schema\group.schema.ts", "TypeScript", 48, 0, 5, 7, 60
"c:\Serious Project\chc\chc-backend\identity-service\group-backend-project\src\schema\groupJoinRequest.schema.ts", "TypeScript", 36, 0, 3, 5, 44
"c:\Serious Project\chc\chc-backend\identity-service\group-backend-project\src\schema\post.schema.ts", "TypeScript", 53, 0, 3, 7, 63
"c:\Serious Project\chc\chc-backend\identity-service\group-backend-project\src\schema\user.schema.ts", "TypeScript", 65, 0, 6, 8, 79
"c:\Serious Project\chc\chc-backend\identity-service\group-backend-project\src\server.ts", "TypeScript", 52, 0, 12, 20, 84
"c:\Serious Project\chc\chc-backend\identity-service\group-backend-project\src\services\auth.service.ts", "TypeScript", 55, 0, 0, 10, 65
"c:\Serious Project\chc\chc-backend\identity-service\group-backend-project\src\services\friendRequest.service.ts", "TypeScript", 83, 0, 8, 15, 106
"c:\Serious Project\chc\chc-backend\identity-service\group-backend-project\src\services\group.service.ts", "TypeScript", 88, 0, 3, 16, 107
"c:\Serious Project\chc\chc-backend\identity-service\group-backend-project\src\services\groupJoinRequest.service.ts", "TypeScript", 86, 0, 5, 14, 105
"c:\Serious Project\chc\chc-backend\identity-service\group-backend-project\src\services\user.service.ts", "TypeScript", 126, 0, 0, 19, 145
"c:\Serious Project\chc\chc-backend\identity-service\group-backend-project\src\tests\ApiTest.http", "HTTP", 0, 6, 1, 1, 8
"c:\Serious Project\chc\chc-backend\identity-service\group-backend-project\src\types\api.types.ts", "TypeScript", 12, 0, 0, 3, 15
"c:\Serious Project\chc\chc-backend\identity-service\group-backend-project\src\types\auth.types.ts", "TypeScript", 11, 0, 0, 2, 13
"c:\Serious Project\chc\chc-backend\identity-service\group-backend-project\src\types\group.types.ts", "TypeScript", 21, 0, 0, 6, 27
"c:\Serious Project\chc\chc-backend\identity-service\group-backend-project\src\types\post.types.ts", "TypeScript", 0, 0, 0, 1, 1
"c:\Serious Project\chc\chc-backend\identity-service\group-backend-project\src\types\user.types.ts", "TypeScript", 24, 0, 0, 6, 30
"c:\Serious Project\chc\chc-backend\identity-service\group-backend-project\src\validations\util.validation.ts", "TypeScript", 0, 0, 0, 1, 1
"c:\Serious Project\chc\chc-backend\identity-service\src\Validators\util.Validator.ts", "TypeScript", 0, 0, 0, -1, -1
"c:\Serious Project\chc\chc-backend\identity-service\src\common\EnvVars.ts", "TypeScript", -25, 0, -5, -2, -32
"c:\Serious Project\chc\chc-backend\identity-service\src\common\HttpStatusCodes.ts", "TypeScript", -64, 0, -259, -64, -387
"c:\Serious Project\chc\chc-backend\identity-service\src\configs\passport.config.ts", "TypeScript", -35, 0, 0, -5, -40
"c:\Serious Project\chc\chc-backend\identity-service\src\controllers\auth.controller.ts", "TypeScript", -21, 0, 0, -6, -27
"c:\Serious Project\chc\chc-backend\identity-service\src\controllers\user.controller.ts", "TypeScript", -76, 0, 0, -12, -88
"c:\Serious Project\chc\chc-backend\identity-service\src\error\AlreadyExistError.ts", "TypeScript", -12, 0, -3, -5, -20
"c:\Serious Project\chc\chc-backend\identity-service\src\error\ApiError.ts", "TypeScript", -8, 0, -3, -3, -14
"c:\Serious Project\chc\chc-backend\identity-service\src\error\ApiErrorCodes.ts", "TypeScript", -70, 0, -5, -19, -94
"c:\Serious Project\chc\chc-backend\identity-service\src\error\IsNotNumberError.ts", "TypeScript", -12, 0, -3, -3, -18
"c:\Serious Project\chc\chc-backend\identity-service\src\error\LengthError.ts", "TypeScript", -32, 0, -3, -4, -39
"c:\Serious Project\chc\chc-backend\identity-service\src\error\NotEmptyError.ts", "TypeScript", -12, 0, -15, -7, -34
"c:\Serious Project\chc\chc-backend\identity-service\src\error\NotFoundError.ts", "TypeScript", -12, 0, -3, -4, -19
"c:\Serious Project\chc\chc-backend\identity-service\src\error\NotInEnumError.ts", "TypeScript", -13, 0, 0, -4, -17
"c:\Serious Project\chc\chc-backend\identity-service\src\error\NotNullError.ts", "TypeScript", -12, 0, -3, -4, -19
"c:\Serious Project\chc\chc-backend\identity-service\src\error\RouteError.ts", "TypeScript", -9, 0, -4, -5, -18
"c:\Serious Project\chc\chc-backend\identity-service\src\helpers\Validator.ts", "TypeScript", -59, 0, -43, -18, -120
"c:\Serious Project\chc\chc-backend\identity-service\src\helpers\camelCaseifyWithDateConversion.ts", "TypeScript", -39, 0, -12, -7, -58
"c:\Serious Project\chc\chc-backend\identity-service\src\helpers\removeNullValue.ts", "TypeScript", -16, 0, -9, -6, -31
"c:\Serious Project\chc\chc-backend\identity-service\src\helpers\sanitation.ts", "TypeScript", 0, 0, -1, -1, -2
"c:\Serious Project\chc\chc-backend\identity-service\src\index.ts", "TypeScript", -6, 0, -2, -3, -11
"c:\Serious Project\chc\chc-backend\identity-service\src\middlewares\auth.middleware.ts", "TypeScript", -48, 0, -1, -9, -58
"c:\Serious Project\chc\chc-backend\identity-service\src\middlewares\user.middleware.ts", "TypeScript", -56, 0, -1, -5, -62
"c:\Serious Project\chc\chc-backend\identity-service\src\middlewares\util.middleware.ts", "TypeScript", -10, 0, 0, -2, -12
"c:\Serious Project\chc\chc-backend\identity-service\src\models\Comment.ts", "TypeScript", -29, 0, 0, -5, -34
"c:\Serious Project\chc\chc-backend\identity-service\src\models\Group.ts", "TypeScript", -51, 0, 0, -5, -56
"c:\Serious Project\chc\chc-backend\identity-service\src\models\Notification.ts", "TypeScript", -44, 0, 0, -5, -49
"c:\Serious Project\chc\chc-backend\identity-service\src\models\Post.ts", "TypeScript", -50, 0, 0, -5, -55
"c:\Serious Project\chc\chc-backend\identity-service\src\models\Reaction.ts", "TypeScript", -34, 0, 0, -5, -39
"c:\Serious Project\chc\chc-backend\identity-service\src\models\friendRequest.schema.ts", "TypeScript", -36, 0, -4, -6, -46
"c:\Serious Project\chc\chc-backend\identity-service\src\models\user.schema.ts", "TypeScript", -65, 0, -6, -8, -79
"c:\Serious Project\chc\chc-backend\identity-service\src\pre-start.ts", "TypeScript", 0, 0, -8, -3, -11
"c:\Serious Project\chc\chc-backend\identity-service\src\repositories\friendRequest.repository.ts", "TypeScript", -25, 0, 0, -6, -31
"c:\Serious Project\chc\chc-backend\identity-service\src\repositories\user.repository.ts", "TypeScript", -71, 0, -8, -18, -97
"c:\Serious Project\chc\chc-backend\identity-service\src\routes\auth.routes.ts", "TypeScript", -28, 0, 0, -7, -35
"c:\Serious Project\chc\chc-backend\identity-service\src\routes\index.routes.ts", "TypeScript", -7, 0, 0, -5, -12
"c:\Serious Project\chc\chc-backend\identity-service\src\routes\types\express\index.d.ts", "TypeScript", -6, 0, -1, -5, -12
"c:\Serious Project\chc\chc-backend\identity-service\src\routes\types\express\misc.ts", "TypeScript", -7, 0, -1, -5, -13
"c:\Serious Project\chc\chc-backend\identity-service\src\routes\types\types.ts", "TypeScript", -9, 0, -1, -5, -15
"c:\Serious Project\chc\chc-backend\identity-service\src\routes\users.routes.ts", "TypeScript", -42, 0, -1, -9, -52
"c:\Serious Project\chc\chc-backend\identity-service\src\server.ts", "TypeScript", -50, 0, -12, -21, -83
"c:\Serious Project\chc\chc-backend\identity-service\src\services\auth.service.ts", "TypeScript", -55, 0, 0, -10, -65
"c:\Serious Project\chc\chc-backend\identity-service\src\services\database.service.ts", "TypeScript", -29, 0, -1, -6, -36
"c:\Serious Project\chc\chc-backend\identity-service\src\services\friendRequest.service.ts", "TypeScript", -72, 0, -6, -13, -91
"c:\Serious Project\chc\chc-backend\identity-service\src\services\user.service.ts", "TypeScript", -81, 0, 0, -12, -93
"c:\Serious Project\chc\chc-backend\identity-service\src\tests\ApiTest.http", "HTTP", 0, -6, -1, -1, -8
"c:\Serious Project\chc\chc-backend\identity-service\src\types\api.types.ts", "TypeScript", -11, 0, 0, -4, -15
"c:\Serious Project\chc\chc-backend\identity-service\src\types\auth.types.ts", "TypeScript", -11, 0, 0, -2, -13
"c:\Serious Project\chc\chc-backend\identity-service\src\types\user.types.ts", "TypeScript", -24, 0, 0, -6, -30
"c:\Serious Project\chc\chc-backend\identity-service\src\util\handlers.ts", "TypeScript", -10, 0, 0, -2, -12
"c:\Serious Project\chc\chc-backend\identity-service\src\util\misc.ts", "TypeScript", -10, 0, -9, -4, -23
"Total", "-", 723, 0, 16, 111, 850